E,E,E,E,E
E,G,E,E,E
E,E,E,E,E
E,E,P,E,E
E,E,E,E,E