E,E,E,E,E,E,E,E,E
E,W,W,E,E,E,W,W,E
E,W,PM;C1;RRRR,E,E,E,E,W,E
E,W,E,E,G,E,E,W,E
E,W,E,E,E,E,E,W,P
E,W,E,E,E,E,PM;C1;LLLL,W,E
E,W,W,E,E,E,W,W,E
E,E,E,E,E,E,E,E,E