E,E,E,E,W,PM;B1;DDRRUU,G,E,W,E,E,E,E
E,W,E,E,W,E,E,E,W,E,E,W,E
E,W,E,E,W,E,E,E,W,E,E,W,E
E,W,E,E,W,W,E,W,W,E,E,W,E
E,W,E,E,E,E,E,E,E,E,E,W,E
E,W,PM;B2;RRRRRRRR,E,E,E,E,E,E,E,E,W,E
E,W,W,W,W,W,W,W,W,W,W,W,E
E,E,E,W,E,E,E,E,E,W,E,E,E
PM;C1;RRDDLLUU,E,E,W,E,E,PM;C1;RDDLLUUR,E,E,W,E,E,PM;C1;LLDDRRUU
E,W,E,E,E,E,W,E,E,E,E,W,E
E,E,E,E,E,E,E,E,E,E,E,E,E
E,E,E,W,E,E,E,E,E,W,E,E,E
E,E,E,W,E,E,P,E,E,W,E,E,E
