E,E,E,E,E,E,E,E,E,E,E,E,E,E,E
E,G,W,E,E,E,E,W,E,E,E,E,W,E,E
E,W,W,W,E,E,E,W,E,E,E,W,W,W,E
E,E,W,E,E,W,W,W,W,W,E,E,W,E,E
E,E,E,E,E,E,PM;C1;LLLLLL,W,PM;C1;RRRRRR,E,E,E,E,E,E
E,E,W,E,E,E,E,W,E,E,E,E,W,E,E
E,W,W,W,E,E,E,E,E,E,E,W,W,W,E
E,E,W,E,E,E,E,E,E,E,E,E,W,E,E
HM;C1,E,E,E,E,E,E,E,E,E,E,E,E,E,P
